001	svet
002	Afrika
003	Severnoamerički kontinent
005	Južna Amerika
009	Okeanija
011	Zapadna Afrika
013	Centralna Amerika
014	Istočna Afrika
015	Severna Afrika
017	Centralna Afrika
018	Južna Afrika
019	Severna i Južna Amerika
021	Severna Amerika
029	Karibi
030	Istočna Azija
034	Južna Azija
035	Jugoistočna Azija
039	Južna Evropa
053	Australija i Novi Zeland
054	Melanezija
057	Mikronezijski region
061	Polinezija
142	Azija
143	Centralna Azija
145	Zapadna Azija
150	Evropa
151	Istočna Evropa
154	Severna Evropa
155	Zapadna Evropa
419	Latinska Amerika
AL	Albanija
DZ	Alžir
VI	Američka Devičanska Ostrva
AS	Američka Samoa
AD	Andora
AO	Angola
AI	Angvila
AQ	Antarktik
AG	Antigva i Barbuda
AR	Argentina
AW	Aruba
AU	Australija
AT	Austrija
AF	Avganistan
AZ	Azerbejdžan
BS	Bahami
BH	Bahrein
BD	Bangladeš
BB	Barbados
BE	Belgija
BZ	Belize
BY	Belorusija
BJ	Benin
BM	Bermuda
BW	Bocvana
BO	Bolivija
BA	Bosna i Hercegovina
CX	Božićno ostrvo
BR	Brazil
VG	Britanska Devičanska Ostrva
IO	Britanska teritorija u Indijskom okeanu
BN	Brunej
BG	Bugarska
BF	Burkina Faso
BI	Burundi
BT	Butan
CF	Centralnoafrička Republika
ME	Crna Gora
TD	Čad
CZ	Češka
CL	Čile
DK	Danska
DG	Dijego Garsija
DM	Dominika
DO	Dominikanska Republika
JE	Džersi
DJ	Džibuti
EG	Egipat
EC	Ekvador
GQ	Ekvatorijalna Gvineja
ER	Eritreja
EE	Estonija
ET	Etiopija
EU	Evropska Unija
FO	Farska Ostrva
FJ	Fidži
PH	Filipini
FI	Finska
FK	Foklandska ostrva
FR	Francuska
GF	Francuska Gvajana
PF	Francuska Polinezija
TF	Francuske Južne Teritorije
GA	Gabon
GM	Gambija
GH	Gana
GI	Gibraltar
GR	Grčka
GD	Grenada
GL	Grenland
GE	Gruzija
GU	Guam
GG	Gurnsi
GP	Gvadelupe
GY	Gvajana
GT	Gvatemala
GN	Gvineja
GW	Gvineja-Bisao
HT	Haiti
NL	Holandija
HN	Honduras
HK	Hong Kong
HR	Hrvatska
IN	Indija
ID	Indonezija
IQ	Irak
IR	Iran
IE	Irska
IS	Island
TL	Istočni Timor
IT	Italija
IL	Izrael
JM	Jamajka
JP	Japan
YE	Jemen
AM	Jermenija
JO	Jordan
GS	Južna Džordžija i Južna Sendvič Ostrva
KR	Južna Koreja
SS	Južni Sudan
ZA	Južnoafrička Republika
KY	Kajmanska Ostrva
KH	Kambodža
CM	Kamerun
CA	Kanada
IC	Kanarska ostrva
BQ	Karipska Holandija
QA	Katar
KZ	Kazahstan
KE	Kenija
CN	Kina
CY	Kipar
KG	Kirgistan
KI	Kiribati
CC	Kokosova (Kilingova) Ostrva
CO	Kolumbija
KM	Komorska Ostrva
CG	Kongo - Brazavil
CD	Kongo - Kinšasa
XK	Kosovo
CR	Kostarika
CU	Kuba
CK	Kukova Ostrva
CW	Kurasao
KW	Kuvajt
LA	Laos
LS	Lesoto
LV	Letonija
LB	Liban
LR	Liberija
LY	Libija
LI	Lihtenštajn
LT	Litvanija
LU	Luksemburg
MG	Madagaskar
HU	Mađarska
YT	Majot
MO	Makao
MK	Makedonija
MW	Malavi
MV	Maldivi
MY	Malezija
ML	Mali
MT	Malta
MA	Maroko
MH	Maršalska Ostrva
MQ	Martinik
MU	Mauricijus
MR	Mauritanija
MX	Meksiko
MM	Mijanmar (Burma)
FM	Mikronezija
MD	Moldavija
MC	Monako
MN	Mongolija
MS	Monserat
MZ	Mozambik
NA	Namibija
NR	Nauru
DE	Nemačka
NP	Nepal
ZZ	Nepoznat region
NE	Niger
NG	Nigerija
NI	Nikaragva
NU	Niue
NO	Norveška
NC	Nova Kaledonija
NZ	Novi Zeland
CI	Obala Slonovače
QO	Okeanija (udaljena ostrva)
AX	Olandska ostrva
OM	Oman
HM	Ostrva Herd i Mekdonald
TC	Ostrva Turks i Kaikos
AC	Ostrvo Asension
BV	Ostrvo Buve
CP	Ostrvo Kliperton
IM	Ostrvo Man
NF	Ostrvo Norfok
PK	Pakistan
PW	Palau
PS	Palestina
PA	Panama
PG	Papua Nova Gvineja
PY	Paragvaj
PE	Peru
PN	Pitkern
PL	Poljska
PR	Portoriko
PT	Portugal
RE	Reinion
RW	Ruanda
RO	Rumunija
RU	Rusija
US	SAD
SV	Salvador
WS	Samoa
SM	San Marino
ST	Sao Tome i Principe
SA	Saudijska Arabija
SC	Sejšeli
PM	Sen Pjer i Mikelon
SN	Senegal
KN	Sent Kits i Nevis
MF	Sent Martin
VC	Sent Vinsent i Grenadini
EA	Seuta i Melilja
KP	Severna Koreja
MP	Severna Marijanska Ostrva
SL	Sijera Leone
SG	Singapur
SY	Sirija
SK	Slovačka
SI	Slovenija
SB	Solomonska Ostrva
SO	Somalija
RS	Srbija
SD	Sudan
SR	Surinam
SJ	Svalbard i Jan Majen
SZ	Svazilend
SH	Sveta Jelena
LC	Sveta Lucija
BL	Sveti Bartolomej
SX	Sveti Martin
ES	Španija
LK	Šri Lanka
CH	Švajcarska
SE	Švedska
TJ	Tadžikistan
TH	Tajland
TW	Tajvan
TZ	Tanzanija
TG	Togo
TK	Tokelau
TO	Tonga
TT	Trinidad i Tobago
TA	Tristan da Kunja
TN	Tunis
TM	Turkmenistan
TR	Turska
TV	Tuvalu
UM	Udaljena ostrva SAD
UG	Uganda
AE	Ujedinjeni Arapski Emirati
GB	UK
UA	Ukrajina
UY	Urugvaj
UZ	Uzbekistan
WF	Valis i Futuna
VU	Vanuatu
VA	Vatikan
VE	Venecuela
VN	Vijetnam
ZM	Zambija
EH	Zapadna Sahara
CV	Zelenortska Ostrva
ZW	Zimbabve
