001	Svet
002	Afrika
003	Severna Amerika
005	Južna Amerika
009	Oceanija
011	Zahodna Afrika
013	Srednja Amerika
014	Vzhodna Afrika
015	Severna Afrika
017	Srednja Afrika
018	Južna Afrika
019	Amerike
021	severnoameriška celina
029	Karibi
030	Vzhodna Azija
034	Južna Azija
035	Jugovzhodna Azija
039	Južna Evropa
053	Avstralija in Nova Zelandija
054	Melanezija
057	mikronezijska regija
061	Polinezija
142	Azija
143	Osrednja Azija
145	Zahodna Azija
150	Evropa
151	Vzhodna Evropa
154	Severna Evropa
155	Zahodna Evropa
419	Latinska Amerika
AF	Afganistan
AX	Ålandski otoki
AL	Albanija
DZ	Alžirija
AS	Ameriška Samoa
VI	Ameriški Deviški otoki
AD	Andora
AO	Angola
AI	Angvila
AQ	Antarktika
AG	Antigva in Barbuda
AR	Argentina
AM	Armenija
AW	Aruba
AU	Avstralija
AT	Avstrija
AZ	Azerbajdžan
BS	Bahami
BH	Bahrajn
BD	Bangladeš
BB	Barbados
BE	Belgija
BZ	Belize
BY	Belorusija
BJ	Benin
BM	Bermudi
BW	Bocvana
BG	Bolgarija
BO	Bolivija
BA	Bosna in Hercegovina
BV	Bouvetov otok
CX	Božični otok
BR	Brazilija
VG	Britanski Deviški otoki
IO	Britansko ozemlje v Indijskem oceanu
BN	Brunej
BF	Burkina Faso
BI	Burundi
BT	Butan
TD	Čad
CF	Centralnoafriška republika
CZ	Češka
EA	Ceuta in Melilla
CL	Čile
CY	Ciper
CK	Cookovi otoki
ME	Črna gora
CW	Curaçao
DK	Danska
CD	Demokratična republika Kongo
DG	Diego Garcia
DM	Dominika
DO	Dominikanska republika
UM	Druga ameriška ozemlja v Tihem oceanu
DJ	Džibuti
EG	Egipt
EC	Ekvador
GQ	Ekvatorialna Gvineja
ER	Eritreja
EE	Estonija
ET	Etiopija
EU	Evropska unija
FK	Falklandski otoki
FO	Ferski otoki
FJ	Fidži
PH	Filipini
FI	Finska
FR	Francija
GF	Francoska Gvajana
PF	Francoska Polinezija
TF	Francosko južno ozemlje
GA	Gabon
GM	Gambija
GH	Gana
GI	Gibraltar
GR	Grčija
GD	Grenada
GL	Grenlandija
GE	Gruzija
GU	Guam
GG	Guernsey
GP	Gvadalupe
GY	Gvajana
GT	Gvatemala
GN	Gvineja
GW	Gvineja Bissau
HT	Haiti
HM	Heardov otok in McDonaldovi otoki
HN	Honduras
HK	Hongkong
HR	Hrvaška
IN	Indija
ID	Indonezija
IQ	Irak
IR	Iran
IE	Irska
IS	Islandija
IT	Italija
IL	Izrael
JM	Jamajka
JP	Japonska
YE	Jemen
JE	Jersey
JO	Jordanija
GS	Južna Georgia in Južni Sandwichevi otoki
KR	Južna Koreja
SS	Južni Sudan
ZA	Južnoafriška republika
KY	Kajmanski otoki
KH	Kambodža
CM	Kamerun
CA	Kanada
IC	Kanarski otoki
QA	Katar
KZ	Kazahstan
KE	Kenija
KG	Kirgizistan
KI	Kiribati
CN	Kitajska
CC	Kokosovi otoki
CO	Kolumbija
KM	Komori
CG	Kongo - Brazzaville
XK	Kosovo
CR	Kostarika
CU	Kuba
KW	Kuvajt
LA	Laos
LV	Latvija
LS	Lesoto
LB	Libanon
LR	Liberija
LY	Libija
LI	Lihtenštajn
LT	Litva
LU	Luksemburg
MO	Macao
MG	Madagaskar
HU	Madžarska
MK	Makedonija
MW	Malavi
MV	Maldivi
MY	Malezija
ML	Mali
MT	Malta
MA	Maroko
MH	Marshallovi otoki
MQ	Martinik
MU	Mauritius
MR	Mavretanija
YT	Mayotte
MX	Mehika
FM	Mikronezija
MM	Mjanmar (Burma)
MD	Moldavija
MC	Monako
MN	Mongolija
MS	Montserrat
MZ	Mozambik
NA	Namibija
NR	Nauru
DE	Nemčija
NP	Nepal
ZZ	Neznano ali neveljavno območje
NE	Niger
NG	Nigerija
NI	Nikaragva
NU	Niue
NL	Nizozemska
BQ	Nizozemski Karibi
NF	Norfolški otok
NO	Norveška
NC	Nova Kaledonija
NZ	Nova Zelandija
OM	Oman
QO	Ostala oceanija
TC	Otočji Turks in Caicos
AC	Otok Ascension
CP	Otok Clipperton
IM	Otok Man
PK	Pakistan
PW	Palau
PS	Palestina
PA	Panama
PG	Papua Nova Gvineja
PY	Paragvaj
PE	Peru
PN	Pitcairn
PL	Poljska
PR	Portoriko
PT	Portugalska
RE	Reunion
RO	Romunija
RW	Ruanda
RU	Rusija
BL	Saint Barthélemy
KN	Saint Kitts in Nevis
LC	Saint Lucia
MF	Saint Martin
PM	Saint Pierre in Miquelon
VC	Saint Vincent in Grenadine
SB	Salomonovi otoki
SV	Salvador
WS	Samoa
SM	San Marino
ST	Sao Tome in Principe
SA	Saudova Arabija
SC	Sejšeli
SN	Senegal
KP	Severna Koreja
MP	Severni Marianski otoki
SL	Sierra Leone
SG	Singapur
SX	Sint Maarten
SY	Sirija
CI	Slonokoščena obala
SK	Slovaška
SI	Slovenija
SO	Somalija
ES	Španija
RS	Srbija
LK	Šrilanka
SD	Sudan
SR	Surinam
SJ	Svalbard in Jan Mayen
SZ	Svazi
SE	Švedska
SH	Sveta Helena
CH	Švica
TJ	Tadžikistan
TH	Tajska
TW	Tajvan
TZ	Tanzanija
TG	Togo
TK	Tokelau
TO	Tonga
TT	Trinidad in Tobago
TA	Tristan da Cunha
TN	Tunizija
TR	Turčija
TM	Turkmenistan
TV	Tuvalu
UG	Uganda
UA	Ukrajina
UY	Urugvaj
UZ	Uzbekistan
VU	Vanuatu
VA	Vatikan
VE	Venezuela
VN	Vietnam
TL	Vzhodni Timor
WF	Wallis in Futuna
EH	Zahodna Sahara
ZM	Zambija
US	ZDA
AE	Združeni arabski emirati
CV	Zelenortski otoki
ZW	Zimbabve
GB	ZK
