001	विश्व
002	अफ़्रीका
003	उत्तर अमेरिका
005	दक्षिण अमेरिका
009	ओशिआनिया
011	पश्चिमी अफ़्रीका
013	मध्य अमेरिका
014	पूर्वी अफ़्रीका
015	उत्तरी अफ़्रीका
017	मध्य अफ़्रीका
018	दक्षिणी अफ़्रीका
019	अमेरिकाज़
021	उत्तरी अमेरिका
029	कैरिबियन
030	पूर्वी एशिया
034	दक्षिणी एशिया
035	दक्षिण-पूर्व एशिया
039	दक्षिणी यूरोप
053	ऑस्ट्रेलेशिया
054	मेलानेशिया
057	माइक्रोनेशियाई क्षेत्र
061	पोलीनेशिया
142	एशिया
143	मध्य एशिया
145	पश्चिमी एशिया
150	यूरोप
151	पूर्वी यूरोप
154	उत्तरी यूरोप
155	पश्चिमी यूरोप
419	लैटिन अमेरिका
AO	अंगोला
AZ	अज़रबैजान
ZZ	अज्ञात क्षेत्र
AQ	अंटार्कटिका
AF	अफ़गानिस्तान
US	अमेरिका
AS	अमेरिकी समोआ
AW	अरूबा
AR	अर्जेंटीना
SV	अल सल्वाडोर
DZ	अल्जीरिया
AL	अल्बानिया
AC	असेंशन द्वीप
IM	आइल ऑफ़ मैन
IS	आइसलैंड
QO	आउटलाइंग ओशिनिया
IE	आयरलैंड
AM	आर्मेनिया
EC	इक्वाडोर
GQ	इक्वेटोरियल गिनी
IT	इटली
ID	इंडोनेशिया
ET	इथियोपिया
IQ	इराक
ER	इरिट्रिया
IL	इसराइल
IR	ईरान
UZ	उज़्बेकिस्तान
KP	उत्तर कोरिया
MP	उत्तरी मारियाना द्वीपसमूह
UY	उरूग्वे
AI	एंग्विला
AG	एंटिगुआ और बरबुडा
AD	एंडोरा
AX	एलैंड द्वीपसमूह
EE	एस्टोनिया
AT	ऑस्ट्रिया
AU	ऑस्ट्रेलिया
OM	ओमान
KZ	कज़ाखस्तान
QA	क़तर
CA	कनाडा
KH	कंबोडिया
CD	कांगो - किंशासा
CG	कांगो – ब्राज़ाविल
KI	किरिबाती
KG	किर्गिज़स्तान
CK	कुक द्वीपसमूह
KW	कुवैत
KE	केन्या
CV	केप वर्ड
KY	केमैन द्वीपसमूह
IC	कैनेरी द्वीपसमूह
CM	कैमरून
BQ	कैरिबियन नीदरलैंड
CC	कोकोस (कीलिंग) द्वीपसमूह
CI	कोट डी आइवर
KM	कोमोरोस
CO	कोलंबिया
XK	कोसोवो
CR	कोस्टारिका
CU	क्यूबा
CW	क्यूरासाओ
CX	क्रिसमस द्वीप
HR	क्रोएशिया
CP	क्लिपर्टन द्वीप
GY	गयाना
GG	गर्नसी
GM	गाम्बिया
GN	गिनी
GW	गिनी-बिसाउ
GU	गुआम
GA	गैबॉन
GL	ग्रीनलैंड
GD	ग्रेनाडा
GT	ग्वाटेमाला
GP	ग्वाडेलूप
GH	घाना
TD	चाड
CL	चिली
CN	चीन
CZ	चेक गणराज्य
JM	जमैका
DE	जर्मनी
JE	जर्सी
JP	जापान
ZM	ज़ाम्बिया
DJ	जिबूती
GI	जिब्राल्टर
ZW	ज़िम्बाब्वे
GE	जॉर्जिया
JO	जॉर्डन
TO	टोंगा
TG	टोगो
TN	ट्यूनीशिया
DG	डिएगो गार्सिया
DK	डेनमार्क
DO	डोमिनिकन गणराज्य
DM	डोमिनिका
TZ	तंज़ानिया
TW	ताइवान
TJ	ताजिकिस्तान
TL	तिमोर-लेस्त
TC	तुर्क और कैकोज़ द्वीपसमूह
TM	तुर्कमेनिस्तान
TR	तुर्की
TV	तुवालू
TK	तोकेलाउ
TT	त्रिनिदाद और टोबैगो
TA	त्रिस्टान डा कुना
TH	थाईलैंड
ZA	दक्षिण अफ़्रीका
KR	दक्षिण कोरिया
GS	दक्षिण जॉर्जिया और दक्षिण सैंडविच द्वीपसमूह
SS	दक्षिण सूडान
NE	नाइजर
NG	नाइजीरिया
NR	नाउरु
NA	नामीबिया
NI	निकारागुआ
NL	नीदरलैंड
NU	नीयू
NP	नेपाल
NF	नॉरफ़ॉक द्वीप
NO	नॉर्वे
NC	न्यू कैलेडोनिया
NZ	न्यूज़ीलैंड
PA	पनामा
PW	पलाऊ
EH	पश्चिमी सहारा
PK	पाकिस्तान
PG	पापुआ न्यू गिनी
PN	पिटकैर्न द्वीपसमूह
PT	पुर्तगाल
PY	पेराग्वे
PE	पेरू
PR	पोर्टो रिको
PL	पोलैंड
FJ	फ़िजी
FI	फ़िनलैंड
PH	फ़िलिपींस
PS	फ़िलिस्तीन
FO	फ़ेरो द्वीपसमूह
FK	फ़ॉकलैंड द्वीपसमूह
FR	फ़्रांस
TF	फ़्रांसीसी दक्षिणी क्षेत्र
GF	फ़्रेंच गयाना
PF	फ़्रेंच पोलिनेशिया
BM	बरमूडा
BH	बहरीन
BS	बहामास
BD	बांग्लादेश
BB	बारबाडोस
BI	बुरुंडी
BF	बुर्किना फ़ासो
BG	बुल्गारिया
BJ	बेनिन
BY	बेलारूस
BZ	बेलीज़
BE	बेल्जियम
BW	बोत्स्वाना
BO	बोलीविया
BV	बोवेत द्वीप
BA	बोस्निया और हर्ज़ेगोविना
BR	ब्राज़ील
VG	ब्रिटिश वर्जिन द्वीपसमूह
IO	ब्रिटिश हिंद महासागरीय क्षेत्र
BN	ब्रूनेई
IN	भारत
BT	भूटान
MO	मकाऊ
MN	मंगोलिया
CF	मध्य अफ़्रीकी गणराज्य
MW	मलावी
MY	मलेशिया
FM	माइक्रोनेशिया
YT	मायोते
MQ	मार्टीनिक
MH	मार्शल द्वीपसमूह
MV	मालदीव
ML	माली
MT	माल्टा
EG	मिस्र
MG	मेडागास्कर
MX	मैक्सिको
MK	मैसिडोनिया
MR	मॉरिटानिया
MU	मॉरिशस
MD	मॉल्डोवा
MZ	मोज़ांबिक
MS	मोंटसेरात
ME	मोंटेनेग्रो
MC	मोनाको
MA	मोरक्को
MM	म्यांमार (बर्मा)
YE	यमन
UG	युगांडा
UM	यू.एस. आउटलाइंग द्वीपसमूह
VI	यू.एस. वर्जिन द्वीपसमूह
GB	यू.के.
UA	यूक्रेन
GR	यूनान
EU	यूरोपीय संघ
RW	रवांडा
RE	रियूनियन
RU	रूस
RO	रोमानिया
LU	लग्ज़मबर्ग
LR	लाइबेरिया
LA	लाओस
LV	लातविया
LI	लिचेंस्टीन
LT	लिथुआनिया
LY	लीबिया
LB	लेबनान
LS	लेसोथो
VU	वनुआतू
WF	वालिस और फ़्यूचूना
VN	वियतनाम
VA	वेटिकन सिटी
VE	वेनेज़ुएला
LK	श्रीलंका
SA	सऊदी अरब
WS	समोआ
AE	संयुक्त अरब अमीरात
RS	सर्बिया
CY	साइप्रस
ST	साओ टोम और प्रिंसिपे
SL	सिएरा लियोन
SG	सिंगापुर
SX	सिंट मार्टिन
SY	सीरिया
SD	सूडान
SR	सूरीनाम
EA	सेउटा और मेलिला
KN	सेंट किट्स और नेविस
PM	सेंट पिएरे और मिक्वेलान
BL	सेंट बार्थेलेमी
MF	सेंट मार्टिन
LC	सेंट लूसिया
VC	सेंट विंसेंट और ग्रेनाडाइंस
SH	सेंट हेलेना
SN	सेनेगल
SC	सेशेल्स
SM	सैन मेरीनो
SO	सोमालिया
SB	सोलोमन द्वीपसमूह
ES	स्पेन
SK	स्लोवाकिया
SI	स्लोवेनिया
SZ	स्वाज़ीलैंड
SJ	स्वालबार्ड और जान मायेन
CH	स्विट्ज़रलैंड
SE	स्वीडन
HU	हंगरी
HM	हर्ड द्वीप और मैकडोनॉल्ड द्वीपसमूह
HK	हाँग काँग
HT	हैती
HN	होंडूरास
