001	მსოფლიო
002	აფრიკა
003	ჩრდილოეთი ამერიკა
005	სამხრეთი ამერიკა
009	ოკეანეთი
011	დასავლეთი აფრიკა
013	ცენტრალური ამერიკა
014	აღმოსავლეთი აფრიკა
015	ჩრდილოეთი აფრიკა
017	შუა აფრიკა
018	სამხრეთი აფრიკა
019	ამერიკები
021	ამერიკის ჩრდილოეთი
029	კარიბის ზღვა
030	აღმოსავლეთი აზია
034	სამხრეთი აზია
035	სამხრეთ-აღმოსავლეთი აზია
039	სამხრეთი ევროპა
053	ავსტრალაზია
054	მელანეზია
057	მიკრონეზიის რეგიონი
061	პოლინეზია
142	აზია
143	ცენტრალური აზია
145	დასავლეთი აზია
150	ევროპა
151	აღმოსავლეთი ევროპა
154	ჩრდილოეთი ევროპა
155	დასავლეთი ევროპა
419	ლათინური ამერიკა
AU	ავსტრალია
AT	ავსტრია
AF	ავღანეთი
AZ	აზერბაიჯანი
AX	ალანდის კუნძულები
AL	ალბანეთი
DZ	ალჟირი
AC	ამაღლების კუნძული
AS	ამერიკის სამოა
AI	ანგილია
AO	ანგოლა
AD	ანდორა
AQ	ანტარქტიკა
AG	ანტიგუა და ბარბუდა
AE	არაბთა გაერთიანებული საამიროები
AR	არგენტინა
AW	არუბა
TL	აღმოსავლეთი ტიმორი
US	აშშ
VI	აშშ-ის ვირჯინის კუნძულები
UM	აშშ-ის შორეული კუნძულები
NZ	ახალი ზელანდია
NC	ახალი კალედონია
BD	ბანგლადეში
BB	ბარბადოსი
BS	ბაჰამის კუნძულები
BH	ბაჰრეინი
BY	ბელარუსი
BE	ბელგია
BZ	ბელიზი
BJ	ბენინი
BM	ბერმუდი
BO	ბოლივია
BA	ბოსნია და ჰერცეგოვინა
BW	ბოტსვანა
BR	ბრაზილია
IO	ბრიტ. ტერიტ. ინდ. ოკეანეში
VG	ბრიტანეთის ვირჯინის კუნძულები
BN	ბრუნეი
BV	ბუვე
BG	ბულგარეთი
BF	ბურკინა-ფასო
BI	ბურუნდი
BT	ბჰუტანი
GA	გაბონი
GB	გაერთ.სამ.
GY	გაიანა
GM	გამბია
GH	განა
DE	გერმანია
GG	გერნსი
GP	გვადელუპა
GT	გვატემალა
GN	გვინეა
GW	გვინეა-ბისაუ
GI	გიბრალტარი
GD	გრენადა
GL	გრენლანდია
GU	გუამი
DK	დანია
EH	დასავლეთი საჰარა
DG	დიეგო-გარსია
DM	დომინიკა
DO	დომინიკელთა რესპუბლიკა
EG	ეგვიპტე
EU	ევროკავშირი
ET	ეთიოპია
EC	ეკვადორი
GQ	ეკვატორული გვინეა
IQ	ერაყი
ER	ერიტრეა
ES	ესპანეთი
EE	ესტონეთი
VU	ვანუატუ
VE	ვენესუელა
VN	ვიეტნამი
ZM	ზამბია
ZW	ზიმბაბვე
TR	თურქეთი
TM	თურქმენეთი
JM	იამაიკა
JP	იაპონია
YE	იემენი
IN	ინდოეთი
ID	ინდონეზია
JO	იორდანია
IR	ირანი
IE	ირლანდია
IS	ისლანდია
IL	ისრაელი
IT	იტალია
CV	კაბო-ვერდე
KY	კაიმანის კუნძულები
KH	კამბოჯა
CM	კამერუნი
CA	კანადა
IC	კანარის კუნძულები
BQ	კარიბის ნიდერლანდები
QA	კატარი
KE	კენია
CY	კვიპროსი
KI	კირიბატი
CW	კიურასაო
CP	კლიპერტონის კუნძული
CO	კოლუმბია
KM	კომორის კუნძულები
CG	კონგო - ბრაზავილი
CD	კონგო - კინშასა
XK	კოსოვო
CR	კოსტა-რიკა
CI	კოტ-დივუარი
CU	კუბა
CK	კუკის კუნძულები
LA	ლაოსი
LV	ლატვია
LS	ლესოთო
LB	ლიბანი
LR	ლიბერია
LY	ლიბია
LT	ლიტვა
LI	ლიხტენშტაინი
LU	ლუქსემბურგი
MG	მადაგასკარი
MU	მავრიკი
MR	მავრიტანია
YT	მაიოტა
MO	მაკაო
MK	მაკედონია
MW	მალავი
MY	მალაიზია
MV	მალდივის რესპუბლიკა
ML	მალი
MT	მალტა
MA	მაროკო
MQ	მარტინიკა
MH	მარშალის კუნძულები
IM	მენის კუნძული
MX	მექსიკა
MM	მიანმარი (ბირმა)
FM	მიკრონეზია
MZ	მოზამბიკი
MD	მოლდოვა
MC	მონაკო
MS	მონსერატი
ME	მონტენეგრო
MN	მონღოლეთი
NA	ნამიბია
NR	ნაურუ
NP	ნეპალი
NE	ნიგერი
NG	ნიგერია
NL	ნიდერლანდები
NI	ნიკარაგუა
NU	ნიუე
NO	ნორვეგია
NF	ნორფოლკის კუნძული
OM	ომანი
PK	პაკისტანი
PW	პალაუ
PS	პალესტინა
PA	პანამა
PG	პაპუა-ახალი გვინეა
PY	პარაგვაი
PE	პერუ
PN	პიტკერნის კუნძულები
PL	პოლონეთი
PT	პორტუგალია
PR	პუერტო-რიკო
RE	რეუნიონი
RW	რუანდა
RO	რუმინეთი
RU	რუსეთი
GR	საბერძნეთი
SV	სალვადორი
WS	სამოა
ZA	სამხრეთ აფრიკის რესპუბლიკა
GS	სამხრეთი გეორგია და სამხრეთ სენდვიჩის კუნძულები
KR	სამხრეთი კორეა
SS	სამხრეთი სუდანი
SM	სან-მარინო
ST	სან-ტომე და პრინსიპი
SA	საუდის არაბეთი
FR	საფრანგეთი
GF	საფრანგეთის გვიანა
PF	საფრანგეთის პოლინეზია
GE	საქართველო
SC	სეიშელის კუნძულები
BL	სენ-ბართელმი
MF	სენ-მარტენი
PM	სენ-პიერი და მიკელონი
SN	სენეგალი
VC	სენტ-ვინსენტი და გრენადინები
KN	სენტ-კიტსი და ნევისი
LC	სენტ-ლუსია
RS	სერბეთი
EA	სეუტა და მელილა
SZ	სვაზილენდი
SL	სიერა-ლეონე
SG	სინგაპური
SX	სინტ-მარტენი
SY	სირია
SK	სლოვაკეთი
SI	სლოვენია
SB	სოლომონის კუნძულები
SO	სომალი
AM	სომხეთი
SD	სუდანი
SR	სურინამი
TW	ტაივანი
TH	ტაილანდი
TZ	ტანზანია
TJ	ტაჯიკეთი
TC	ტერქსისა და კაიკოსის კუნძულები
TG	ტოგო
TK	ტოკელაუ
TO	ტონგა
TT	ტრინიდადი და ტობაგო
TA	ტრისტან-და-კუნია
TV	ტუვალუ
TN	ტუნისი
UG	უგანდა
UZ	უზბეკეთი
UA	უკრაინა
HU	უნგრეთი
WF	უოლისი და ფუტუნა
UY	ურუგვაი
ZZ	უცნობი რეგიონი
FO	ფარერის კუნძულები
PH	ფილიპინები
FI	ფინეთი
FJ	ფიჯი
FK	ფოლკლენდის კუნძულები
TF	ფრანგული სამხრეთის ტერიტორიები
VA	ქალაქი ვატიკანი
CC	ქოქოსის კუნძულები
KW	ქუვეითი
KZ	ყაზახეთი
KG	ყირგიზეთი
SE	შვედეთი
CH	შვეიცარია
CX	შობის კუნძული
QO	შორეული ოკეანეთი
SJ	შპიცბერგენი და იან-მაიენი
LK	შრი-ლანკა
TD	ჩადი
CZ	ჩეხეთის რესპუბლიკა
CL	ჩილე
CN	ჩინეთი
MP	ჩრდილოეთ მარიანას კუნძულები
KP	ჩრდილოეთი კორეა
CF	ცენტრალური აფრიკის რესპუბლიკა
SH	წმინდა ელენეს კუნძული
HR	ხორვატია
JE	ჯერსი
DJ	ჯიბუტი
HT	ჰაიტი
HM	ჰერდი და მაკდონალდის კუნძულები
HN	ჰონდურასი
HK	ჰონკონგი
