001	ကမ္ဘာ
002	အာဖရိက
003	မြောက် အမေရိက
005	တောင် အမေရိက
009	သမုဒ္ဒရာဒေသ
011	အနောက် အာဖရိက
013	အလယ်ပိုင်း အမေရိက
014	အရှေ့ပိုင်း အာဖရိက
015	မြောက်ပိုင်း အာဖရိက
017	အလယ်ပိုင်း အာဖရိက
018	တောင်ပိုင်း အာဖရိက
019	အမေရိကများ
021	မြောက်ပိုင်း အမေရိက
029	ကာရီဘီယံ
030	အရှေ့ပိုင်း အာရှ
034	တောင်ပိုင်း အာရှ
035	အရှေ့တောင်ပိုင်းအာရှ
039	တောင်ပိုင်း ဥရောပ
053	ဩစတြေးလျနှင့် နယူးဇီလန်
054	မီလာနီးရှား
057	မိုင်ခရိုနီရှားနယ်
061	ပိုလီနီရှား
142	အာရှ
143	အလယ် အာရှ
145	အနောက် အာရှ
150	ဥရောပ
151	အရှေ့ပိုင်း ဥရောပ
154	မြောက်ပိုင်း ဥရောပ
155	အနောက်ပိုင်း ဥရောပ
419	လက်တင်အမေရိက
KE	ကင်ညာ
CM	ကင်မရွန်း
CA	ကနေဒါ
KH	ကမ္ဘောဒီးယား
CU	ကျူးဘား
CP	ကလစ်ပါတန်ကျွန်း
CK	ကွတ် ကျွန်းစု
CD	ကွန်ဂို-ကင်ရှာစ
CG	ကွန်ဂို-ဘရာဇာဗီလ်
KZ	ကာဇက်စတန်
QA	ကာတာ
IC	ကာနာရီကျွန်းစု
BQ	ကာရီဘီယံနယ်သာလန်
CC	ကိုကိုး ကျွန်းစု
XK	ကိုဆိုဗို
KM	ကိုမိုရိုစ်
CO	ကိုလံဘီယာ
KW	ကူဝိတ်
KY	ကေမန် ကျွန်းစု
CR	ကော့စ်တာရီကာ
CZ	ချက် ပြည်ထောင်စု
TD	ချဒ်
CL	ချီလီ
CX	ခရစ်စမတ် ကျွန်း
HR	ခရိုအေးရှား
KG	ခရူဂစ်စတန်
KI	ခီရီဘာတီ
CW	ခူရာကာအို
CV	ခေ့ပ်ဗာဒူ
GM	ဂန်ဘီရာ
JP	ဂျပန်
JM	ဂျမေကာ
JE	ဂျာစီ
DE	ဂျာမဏီ
GI	ဂျီဘရော်လ်တာ
DJ	ဂျီဘူတီ
GE	ဂျော်ဂျီယာ
JO	ဂျော်ဒန်
GL	ဂရင်းလန်း
GR	ဂရိ
GD	ဂရီနာဒါ
GG	ဂွန်းဇီ
GT	ဂွာတီမာလာ
GH	ဂါနာ
GA	ဂါဘွန်
GN	ဂီးနီ
GW	ဂီရာနာ-ဘီစ်စာဥ
GY	ဂူရာနာ
GU	ဂူအမ်
GP	ဂူအာဒီလုပ်
SG	စင်္ကာပူ
ES	စပိန်
SJ	စဗိုလ်ဘတ်နှင့်ဂျန်မေရန်
SK	စလိုဗေးကီးယား
SI	စလိုဗေးနီးယား
SZ	စွာဇီလန်
KN	စိန့်ကစ်နှင့်နီဗီစ်
ST	စိန့်တိုမီနှင့်ပရင်စီပ့်
PM	စိန့်ပီအဲရီနှင့်မီကွီလွန်
VC	စိန့်ဗင့်ဆင့်နှင့် သည်ဂရဲနာဒင်းစ်
BL	စိန့်ဘာသီလီမိုင်
MF	စိန့်မာတင်
LC	စိန့်လူစီအာ
SH	စိန့်ဟဲလီနာ
SX	ဆင့်မာအာတင်
EA	ဆယ်ဥတာနှင့်မယ်လီလ်လာ
CH	ဆွစ်ဇလန်
SE	ဆွီဒင်
RS	ဆားဘီးယား
WS	ဆာမိုအာ
CY	ဆိုက်ပရက်စ်
SO	ဆိုမာလီယာ
SN	ဆီနီဂေါ
SY	ဆီးရီးယား
SL	ဆီအဲရာ လီအိုနီ
SD	ဆူဒန်
SR	ဆူရီနိမ်း
SC	ဆေးရှလ်
SM	ဆော့န်မာရီနို
SA	ဆော်ဒီအာရေးဗီးယား
SB	ဆော်လမွန်ကျွန်းစု
ZW	ဇင်ဘာဘွေ
ZM	ဇမ်ဘီယာ
TC	တခ်စ်နှင့်ကာအီကိုစ်ကျွန်းစု
TZ	တန်ဇန်းနီးယား
CN	တရုတ်
TO	တွန်ဂါ
TM	တာခ်မီန့စ်တန်
TJ	တာဂျီကစ္စတန်
TG	တိုဂို
TN	တူနီးရှား
TR	တူရကီ
GS	တောင် ဂျော်ဂျီယာ နှင့် တောင် ဆင်းဒဝစ်ဂျ် ကျွန်းစုများ
KR	တောင်ကိုရီးယား
MP	တောင်ပိုင်းမာရီအာနာကျွန်းစု
ZA	တောင်အာဖရိက
TA	ထရစ်တန်ဒါကွန်ဟာ
TT	ထရိုင်နီဒတ်နှင့်တိုဘာဂို
TK	ထိုးခါလူ
TH	ထိုင်း
TW	ထိုင်ဝမ်
TV	ထူးဗလူ
DK	ဒိန်းမတ်
DO	ဒိုမီနီကန်
DM	ဒိုမီနီကာ
DG	ဒီအေဂိုဂရာစီအာ
NA	နမ်မီးဘီးယား
NC	နယူး ကယ်လီဒိုနီးယား
NZ	နယူးဇီလန်
NL	နယ်သာလန်
NR	နာဥူရူ
NE	နိုင်ဂျာ
NG	နိုင်ဂျီးရီးယား
NI	နီကာရာဂွာ
NP	နီပေါ
NU	နီဥူအေ
NF	နောဖော့ခ်ကျွန်း
NO	နော်ဝေ
PN	ပစ်တ်ကိန်းကျွန်းစု
PA	ပနားမား
FR	ပြင်သစ်
GF	ပြင်သစ် ဂီယာနာ
TF	ပြင်သစ် တောင်ပိုင်း ပိုင်နက်များ
PF	ပြင်သစ် ပေါ်လီနေးရှား
PW	ပလောင်
PK	ပါကစ္စတန်
PG	ပါပူရာနယူးဂီနီ
PY	ပါရာဂွေး
PS	ပါလက်စတိုင်း
PL	ပိုလန်
PE	ပီရူး
PT	ပေါ်တူဂီ
PR	ပေါ်တူရီကို
FI	ဖင်လန်
FO	ဖာရိုး ကျွန်းစုများ
PH	ဖိလစ်ပိုင်
FJ	ဖီဂျီ
FK	ဖောက်ကလန် ကျွန်းစု
VE	ဗင်နီဇွဲလား
VG	ဗြိတိသျှ ဗာဂျင်း ကျွန်းစု
IO	ဗြိတိသျှ အိန္ဒြိယ သမုဒ္ဒရာ ပိုင်နက်
VA	ဗာတီကန်စီတီး
VU	ဗာနုအာတူ
VN	ဗီယက်နမ်
BD	ဘင်္ဂလားဒေ့ရှ်
BE	ဘယ်လ်ဂျီယမ်
BR	ဘရာဇီး
BN	ဘရူနိုင်း
BS	ဘဟားမား
BF	ဘာကီနာ ဖာဆို
BB	ဘာဘဒိုးစ်
BM	ဘာမူဒါ
BH	ဘာရိန်း
BO	ဘိုလီးဘီးယား
BJ	ဘီနင်
BY	ဘီလာရုစ်
BG	ဘူဂေးရီးယား
BT	ဘူတန်
BV	ဘူဗက်ကျွန်း
BI	ဘူရွန်ဒီ
BZ	ဘေလီဇ်
BA	ဘော့စနီးယား နှင့် ဟာဇီဂိုဘီးနား
BW	ဘော့စ်ဝါနာ
MO	မကာအို
MX	မက္ကဆီကို
IM	မန်ကျွန်း
MM	မြန်မာ
KP	မြောက်ကိုရီးယား
SS	မြောက်ဆူဒန်
MY	မလေးရှား
MN	မွန်ဂိုးလီးယား
ME	မွန်တီနိဂရိုး
ZZ	မသိ သို့မဟုတ် မရှိ သော နေရာ
MK	မာစီဒိုးနီးယား
MQ	မာတီနီကီ
MG	မာဒါဂတ်စကာ
MH	မာရှယ် ကျွန်းစု
MW	မာလာဝီ
ML	မာလီ
FM	မိုင်ခရိုနီရှား
MZ	မိုဇန်ဘစ်
MC	မိုနာကို
YT	မေအိုတီ
MS	မောင့်စဲရက်
MR	မောရီတာနီအာ
MT	မောလ်တာ
MD	မောလ်ဒိုဗာ
MA	မော်ရိုကို
MU	မော်ရေရှားစ်
MV	မော်လ်ဒိုက်
YE	ယီမင်
UA	ယူကရိန်း
GB	ယူကေ
UG	ယူဂန္ဓာ
UM	ယူနိုက်တက်စတိတ် အပြင်ထွက် နေသည့် သေးငယ်သောကျွန်းများ
US	ယူအက်စ်
VI	ယူအက်စ် ဗာဂျင်း ကျွန်းစု
AE	ယူအေအီး
RW	ရဝန်ဒါ
RO	ရိုမေးနီးယား
RU	ရုရှ
RE	ရဲအူနီရွန်
LB	လက်ဘနွန်
LI	လစ်ခ်ထင်စတိုင်
LT	လစ်သူယေးနီးယား
LV	လတ်ဗီးယား
LA	လာအို
LR	လိုင်ဘေးရီးယား
LS	လီဆိုသို
LY	လီဗရာ
LU	လူဇင်ဘတ်
WF	ဝေါလစ်နှင့်ဖူထူးနား
QO	သမုဒ္ဒရာဒေသအပြင်ထွက်နေသောဒေသများ
LK	သီရိလင်္ကာ
HM	ဟတ်ကျွန်းနှင့်မက်ဒေါနယ်ကျွန်းစု
HU	ဟန်ဂေရီ
HN	ဟွန်ဒူးရပ်စ်
HT	ဟေတီ
HK	ဟောင်ကောင်
EE	အက်စတိုးနီးယား
AC	အက်စ်စင်ရှီအွန်ကျွန်း
AO	အင်ဂိုလာ
ID	အင်ဒိုနီးရှား
IL	အစ္စရေး
AZ	အဇာဘိုင်ဂျန်
EH	အနောက်ပိုင်း ဆာဟာရ
AQ	အန္တာတိက
AI	အန်ဂွီလာ
AG	အန်တီဂုအာနှင့်ဘာဘုဒါ
AD	အန်ဒိုရာ
AS	အမေရိကန် စမိုအ
DZ	အယ်လ်ဂျီးရီးယား
SV	အယ်လ်ဆာဗေးဒိုး
TL	အရှေ့တီမော
CF	အလယ်ပိုင်း အာဖရိက ပြည်ထောင်စု
AR	အာဂျင်တီးနား
AF	အာဖဂန်နစ္စတန်
AM	အာမေနီးယား
AW	အာရုဘာ
AX	အာလန်ကျွန်း
IN	အိန္ဒိယ
IS	အိုက်စလန်
CI	အိုင်ဗရီကိုစ့်
IE	အိုင်ယာလန်
OM	အိုမန်
GQ	အီကွေတာ ဂီရာနာ
EC	အီကွေဒေါ
EG	အီဂျစ်
IT	အီတလီ
IQ	အီရတ်
IR	အီရန်
ER	အီရီတရီအာ
ET	အီသီယိုးပီးယား
AL	အဲလ်ဘာနီအာ
UZ	ဥဘက်ကစ္စတန်
UY	ဥရုဂွေး
EU	ဥရောပသမဂ္ဂ
AT	ဩစတြီးယား
AU	ဩစတြေးလျ
